000000000
011111110
011111110
011211210
011111110
011111110
012111110
013411110
011111110
000000000