0000000000
0202000000
0122100000
0020000000
0000120000
0000022000
0000112000
0000020000
0000000000
0000000000