00000000000
01111111000
01111111000
01121121000
01111111000
01111111000
01211111000
01341111000
01111111000
00000000000
