00000000000
01111111000
01111111000
01211121000
01111111000
01111111000
01222221000
01341111000
01111111000
00000000000
