00000000000000000000000000
01111111111100111111111110
02000020000200200002000020
02000020000200200002000020
02000020000200200002000020
01111111111113114111111110
02000020200000000202000020
01111110222200222201111110
00000000000000000000000000