000000000000000000000000000000
011111111111111111111111111100
011111111100001111111111111100
011111111100001111111111111100
011111111100001111111111111100
011121111100001112111111121100
011111111100001111111111111100
011111111111111111111111111100
011111111100000000000001111100
011111111100001111110001111100
011111111100001112110001111100
011111111100001113110001111100
011141111111111111111111115100
011111111111111100001111111100
011111111111111100001111111100
011111111111111100001111111100
011111111100001111111111111100
011111111100001111111111111100
011111111100001111111111111100
000000000000000000000000000000