0000000000000
0114111112110
0101010101010
0101010101010
0101010101010
0101010101010
0101010101010
0101010101010
0113111212120
0000000000000