00000000000000000000
01111111111111111000
01111111111111111000
01111111111111111000
01121111111121111000
01111111111111111000
01111111111111111000
01121111111121111000
01111111111111111000
01134111111141111000
01111111111111111000
01111111111111111000
01111111111111111000
01111111111111111000
01121111111121111000
01111111111111111000
01111111111111111000
01121111111121111000
01111111111111111000
00000000000000000000