000000000000000000000000000000
04111111111111111111111111111
011000000000001111111100011111
011111111111111222011111111111
011111111111111111011111111111
011111111110111111111011111111
011000001110001011222011022111
011111111111111111111000001111
011000001111011111111011111111
011311110011011111111111111112
011012211111011000000001111122
011011211111011111111111111122
011011211110222000000011022211
011112221111011111011111111112
011111011111011111011111111111
022211111112211111111111111111
000000000000000000000000000122
011010101011000000000000000000
000000000000000000000000000000